########
#@ #...#
#  $$  #
# $   ##
#  #### 
#  #    
####    
