#######
#. # .#
# $@$ #
#  #  #
#######
