########
#@ #   #
#  #.  #
#  # $ #
## $ ###
 #   #  
 #.  #  
 #####  
